WWWWWWWWWWWWWWWWWWWW
WT....W.............
W.WWW.W.W.W.W.W.WW.W
W...W.W.W.W.W...W..W
WWW.W.W...WWWWW.WW.W
W...W...W.....W....W
W.WWWWWWW.WWWWW.WWWW
W.W.......W.......WW
W.W.WWWWW.W.WWWWW.WW
W.W.....W.W.W.....WW
W.WWWWW.W.W.WWGWWWWW
W.....W.W.........WW
WWW.WWW.WWWW.WWWW.WW
W..............W...W
WWWWWWWWWWWWWWWWWWWW
